11111111111111111111111
1RRRRRRRRRRRRRRRRRRRRR1
1RRRRRRRRRRRRRRRRRRRRR1
1RRRRRRRRRRRRRRRRRRRRR1
1RRRRRRRRRRRRRRRRRRRRR1
1RRRRRRRRRRRRRRRRRRRRR1
1RRRRRRRRRRRRRRRRRRRRR1
1RRRRRRRRRRRRRRRRRRRRR1
1L0L010R000000000000001
10010C00000000000000001
101P0100000000000000001
10CE0100000000000000001
11111111111111111111111
