1111111111111
1100001001101
100110C001101
1000101001101
101010C001101
1011P01001101
10C1E01001101
1111111111111
