1111111111
1000110001
10010C0001
100XX10001
10010C0001
101P010001
10CE010001
1111111111
