1111111111
1000110001
10010C0001
1R00000X01
11000C0001
100P010001
10CE01R001
1111111111
