1111111111111111111111111111111111111111111111111
1000001010000000000001010000000001000000000100001
10100P00000010RL0000000010010000RXC11100010000001
100100000C111101000000000001011011111XX0111100101
1000001010000000000001010000000001000000000100001
1110R000010111100DXX011111010100000000000CLC11011
10000E1010000000000001010000000001000000000100001
1000001010000000000001010000000001000000000100001
1000001010000000000001010000000001000000000100001
1110R000010111100DXX011111010100000000000CLC11011
10100000000010RL0000000010010000RXC11100010000001
1000001010000000000001010000000001000000000100001
100100000C111101000000000001011011111XX0111100101
1000001010000000000001010000000001000000000100001
100100000C111101000000000001011011111XX0111100101
1000001010000000000001010000000001000000000100001
1110R000010111100DXX011111010100000000000CLC11011
10100000000010RL0000000010010000RXC11100010000001
10100000000010RL0000000010010000RXC11100010000001
10100000000010RL0000000010010000RXC11100010000001
1110R000010111100DXX011111010100000000000CLC11011
100100000C111101000000000001011011111XX0111100101
100100000C111101000000000001011011111XX0111100101
10100000000010RL0000000010010000RXC11100010000001
100100000C111101000000000001011011111XX0111100101
1000001010000000000001010000000001000000000100001
1110R000010111100DXX011111010100000000000CLC11011
1000001010000000000001010000000001000000000100001
1000001010000000000001010000000001000000000100001
100100000C111101000000000001011011111XX0111100101
10100000000010RL0000000010010000RXC11100010000001
100100000C111101000000000001011011111XX0111100101
10100000000010RL0000000010010000RXC11100010000001
1110R000010111100DXX011111010100000000000CLC11011
10100000000010RL0000000010010000RXC11100010000001
1110R000010111100DXX011111010100000000000CLC11011
1000001010000000000001010000000001000000000100001
10100000000010RL0000000010010000RXC11100010000001
1110R000010111100DXX011111010100000000000CLC11011
10100000000010RL0000000010010000RXC11100010000001
1000001010000000000001010000000001000000000100001
1111111111111111111111111111111111111111111111111
