11111111111111111111
10111111111100000001
10111111110000000001
101C0L0R00L101111111
1010L0000R1100000011
101L000L0101000X0C11
101LR000100100XX1001
1010111010010XX00001
10101010100101000001
101010101001BBBBB001
101010101001111111D1
10101010100100000001
101010101001000E0001
101P101C100100000C01
10111011100111111111
10000000000000000001
11111111111111111111
