11111111111111111111
10111111111100000001
10111111110000000001
101CR00000L101111111
1010R0000L1100000011
10100R00L101000X0C11
101000LR100100XX1001
1010111010010XX00001
10101010100101000001
101010101001BBBBB001
101010101001111111D1
10101010100100000001
101010101001000E0001
101P101C100100000C01
10111011100111111111
10000000000000000001
11111111111111111111
