11111111111111111111
10111111111100000001
101C000X000000011111
10100L00000101111111
1010L0S00R1100000011
1010000L010100000011
101LR000101000000001
101011101010000000b1
10101010101000000b01
101010101001CX00b0C1
10101010100111D11111
10101010100100000001
101010101001000E0001
101P101C100100000001
10111011100111111111
10000000000000000001
11111111111111111111
