1111111111
10010C0001
1U0000SX01
11000C0001
100P010001
10CE01U001
1111111111
