11111111111
11100110001
100010C0001
1000XX10001
100110C0001
1010P010001
10C1E110001
11111111111
